25 22
0000000000000000000000122
0000000000000000000000122
1111110000000000000000022
0000000000000000111100122
0000000000010000000011122
0000000100000000000011122
1111100000000000000001122
0000000000000000000012222
0000000000000000011111122
2102102000012001200000122
1212100000122102102110022
0000000000000000000110022
1111111111111110000000022
1111111111111111111111122
2000001111111010000011122
1100000000000000000111112
1100000001110000000011112
1110000001111100000111112
1100000000111100000111112
2222222222222222222222222
2222222222222222222222222
1222122222222221111111111