24 20
000000000000000000000012
000000000000000000000012
111111000000000000000002
000000000000000011110012
000000000001000000001112
000000010000000000001112
111110000000000000000112
000000000000000000001222
000000000000000001111112
210210200001200120000012
121210000012210210211002
000000000000000000011002
111111111111111000000002
111111111111111111111112
200000111111101000001112
110000000000000000011111
110000000111000000001111
111000000111110000011111
110000000011110000011111
222222222222222222222222